1
6
####S#
#....#
#.##*#
#....#
#...*#
####E#